+------------------------+
 /                    =c |
 /                    =  |
+-                       |
|                     =  |
|                        |
|                        |
|                        |
|                        |
+-                       |
 /                       |
 /                       |
+------------------------+